11 11
00000000000
01110111010
01010101010
01010101010
01010101010
01010101010
01010101010
01010101010
01010101010
01011101110
00000000000