20 20
11111111111111111111
11111111100111111111
11111111000001111111
11111001011101011111
11110101110111001111
11100111000000010111
11100100011333010111
11011101110303333011
11010001003300003011
10111101033111103301
10010101111100101111
11010111000011101011
11010000000120011011
11101101122120112111
11101100100100110111
11111112100111101111
11111002110110011111
11111110011001111111
11111111100111111111
11111111111111111111








